111111111111111111111111111111111111
110000000000000000000000000000000011
110000000000000000000000000000000011
110000000000000000000000000000000011
110000000000000000000000000000000011
110000000000000000000000000000000011
1100000000000000000O0000000000000011
110000000000000H00000000000000000011
110000000000000000000000000000000011
110000000000000000000000000000000011
110000000B0000000Z00000000B000000011
112200222222222222222222222222002211
110000000000000000000000000000000011
110000000000000000000000000000000011
1100000000000000O0000000000000000011
110000000000000000000000000000000011
112200222222222222222222222222002211
110000000000000000000000000000000011
110000000000000000000O00000000000011
110000000000000000000000000000000011
110000000000000000000000000000000011
112200222222222222222222222222002211
110000000000000000000000000000000011
110000000000000000000000000000000011
110000000000000000000000000000000011
111111111111111111111111111111111111