111111111111111111111111111111111111
110000000000000000000000000000000011
110000000000000000000000000000000011
1100000000000000000000Z000Z000000011
110000000000000000000000000000000011
110000000000000000000000000000000011
11000000000Z0000Z00000Z0000000000011
110000000000000000000000000000000011
110000000000000000000000000000000011
110000000000000000000000000000000011
110000000Z0000000Z00000000Z000000011
112200222222222222222222222222002211
110000000000000000000000000000000011
110000000000000000000000000000000011
110000000000000000000000000000000011
110000000000000000000000000000000011
112200222222222222222222222222002211
110000000000000000000000000000000011
110000000000000000000000000000000011
110000000000000000000000000000000011
110000000000000000000000000000000011
112200222222222222222222222222002211
110000000000000000000000000000000011
110000000000000000000000000000000011
110000000000000000000000000000000011
111111111111111111111111111111111111