111111111111111111111111111111111111
110000000000000000000000000000000011
110000000000000000000000000000000011
110000000000000000000000000000000011
110000000000000000000000000000000011
110000000000000000000000000000000011
110000000000000000000000000000000011
110000000000000000000000000000000011
110000000000000000000000000000000011
1100000000000000Z0000000000000000011
1100000000000000Z0000000000000000011
1100000000000000Z0000000000000000011
112200222222222222222222222222002211
110000000000000000000000000000000011
110000000000000000000000000000000011
110000000000000000000000000000000011
110000000000000000000000000000000011
112200222222222222222222222222002211
110000000000000000000000000000000011
110000000000000000000000000000000011
110000000000000000000000000000000011
110000000000000000000000000000000011
112200222222222222222222222222002211
110000000000000000000000000000000011
110000000000000000000000000000000011
110003000000000000000000000000000011
111111111111111111111111111111111111
END
