111111111111111111111111111111111111
110000000000000000000000000000000011
110000000000000000000000000000000011
110000000000000000000000000000000011
110000000000000000000000000000000011
110001111011110110001101111000000011
110001001010010101010101000000000011
110001000010010100100101000000000011
110001011011110100000101111000000011
110001001010010100000101000000000011
110001111010010100000101111000000011
110000000000000000000000000000000011
110001111010001011110111110000000011
110001001010001010000100010000000011
110001001010001010000111110000000011
110001001010001011110110000000000011
110001001001010010000101000000000011
110001111000100011110100100000000011
110000000000000000000000000000000011
110000000000000000000000000000000011
110000000000000000000000000000000011
110000000000000000000000000000000011
110000000000000000000000000000000011
110000000000000000000000000000000011
110000000000000000000000000000000011
111111111111111111111111111111111111