111111111444411111111114444111111111
110000000000000000000000000000000011
110000000000000Z0Z0Z0000000000000011
110000000000022222222220000000000011
110000000022222222222222220000000011
11000000O222222222222222222O00000011
1100000O22200220022002200222O0000011
110000022222222222222222222220000011
110000000002222002200222200000000011
110000000000220000000022000000000011
110000000000000000000000000000000011
110000000000000000000000000000000011
110000000000000000000000000000000011
110000000000000000000000000000000011
110000000000000000000000000000000011
110000000000000000000000000000000011
110000000000000000000000000000000011
110000000000000000000000000000000011
110002222220002222222200022222200011
110000000000000000000000000000000011
110000000000000000000000000000000011
110000000000000000000000000000000011
110000000000000011110000000000000011
110000000000000011110000000000000011
110000000000011111111110000000000011
111111111333311111111113333111111111