111111111444411111111114444111111111
110000000000000000500000000000000011
110000000000000000000000000000000011
110000000000000000000000000000000011
110000000000000000000000000000000011
110000000000000000000000000000000011
110000000000000000000000000000000011
110010000001001000000100100000010011
110010000001001000000100100000010011
110010000001001000000100100000010011
11001000B001001000B001001000B0010011
110022222222002222222200222222220011
110000000000000000000000000000000011
110000000000P000000000P0000000000011
110000000000000000000000000000000011
110000000000000006000000000000000011
110000010000001000000100000010000011
110000010000001000000100000010000011
110000010000001000000100000010000011
11000001000B0010000001000B0010000011
110000022222222000000222222220000011
110000000000000000000000000000000011
110000000000000000000000000000000011
110000000000000000000000000000000011
110000000000000000000000000000000011
111111111333311111111113333111111111