111111111444411111111114444111111111
110000000000000000500000000000000011
110000000000000000000000000000000011
110000000222200000000002222000000011
110000022200220000000022002220000011
110000220000022000000220000022000011
110002200000002200002200000002200011
110022000000000220022000000000220011
1100220000O00000220000000O0000220011
110022000000000000000000000000220011
110022000000000000000000000000220011
110002200000000000000000000002200011
110000220000000000000000000022000011
1100000220000O00000000O0000220000011
110000022000000000000000000220000011
110000002200000000000000002200000011
110000000220000000000000022000000011
110000000022000000O00000220000000011
110000000002200000000002200000000011
110000000000220000000022000000000011
11000O00000002200000022000000O000011
110000000000002200002200000000000011
110000000000000220022000000000000011
110000000000000020000000000000000011
110000000000000000000000000000000011
111111111333311111111113333111111111