111111111444411111111114444111111111
110000000000000000500000000000000011
110001000022000000000000220000100011
110001000000000000000000000000100011
110001000000000000000000000000100011
110001M0000000000000000000000M100011
110002222200222222222222002222200011
110000000P0000000000000000P000000011
110000000000000000000000000000000011
110000000000000000000000000000000011
110000000000000000P00000000000000011
110000000000000000000000000000000011
110000000000000000000000000000000011
110000000000000000000000000000000011
110000000000000000000000000000000011
110022222222222222222222222222220011
110000000000000000000000000000000011
112222222220022222222220022222222211
110000000000000000000000000000000011
110022222222222222222222222200222211
110000000000000000000000000000000011
112222222222222200002222222222222211
110000001000000200002000000100000011
110000001000000200002000000100000011
110000001000000000000000000100000011
111111111333311111111113333111111111