111111111444411111111114444111111111
110000000000000000500000000000000011
110000000000000000000000000000000011
110000011111111111111111111110000011
110000111111111111111111111111000011
110001100111100111111001111001100011
110001000011100111111001110000100011
110001000011100111111001110000100011
110001000011100111111001110000100011
110001000011100111111001110000100011
110001000011100111111001110000100011
110001000011100111111001110000100011
1100010P00111P0111111P01110P00100011
110001000011100111111001110000100011
110001000011100111111001110000100011
110001000011100111111001110000100011
110001000011100111111001110000100011
11000110011110011111100111100110011
110000222222222222222222222222000011
110000022222222222222222222220000011
110000000000000000000000000000000011
110000000000000000000000000000000011
110000000000000000000000000000000011
110000000222200000000002222000000011
110000000000000000000000000000000011
111111111333311111111113333111111111