111111111444411111111114444111111111
110000000000000000000000000000000011
110000000000000000000000000000000011
11M00000000000000M000000000000000M11
112222000002222222222222200000222211
110000000000000000000000000000000011
11M00000000000000M000000000000000M11
112220000002222222222222200000022211
110000000000000000000000000000000011
11000000000000000M000000000000000011
112200000000022222222220000000002211
110000000000000000000000000000000011
110000000000000000000000000000000011
112200006000022222222220000060002211
110000000000000000000000000000000011
110000000000000000000000000000000011
112000000000000022220000000000000211
110000000000000000000000000000000011
112000000000000000000000000000000211
110000200000020000000020000002000011
110000000000000000000000000000000011
112222222222222222222222222222222211
110000111111111111111111111111000011
110000111111111111111111111111000011
110000111111111111111111111111000011
111111111111111111111111111111111111