111111111111111111111111111111111111
110000000000000000000000000000000011
110000000000000000000000000000000011
110000000000000000000000000000000011
11000000000000000ZZ00000000000000011
110000000000000000000000000000000011
110006000000000222222000000000060011
110000000000000000000000000000000011
110000000000000000000000000000000011
110000000000000000000000000000000011
1100000000000Z0000000Z00000000000011
110000000002222200022222000000000011
110000000000000000000000000000000011
110000000000000000000000000000000011
110000000000000000000000000000000011
110000000000000000000000000000000011
110000000222222222222222222000000011
110000000000000000000000000000000011
110000000000000000000000000000000011
110000000000000000000000000000000011
110000000000000000000000000000000011
110002222222000222222000222222200011
110000000000000000000000000000000011
110000000000000000000000000000000011
110000000000000000000000000000000011
111111111111111111111111111111111111