111111111444411111111114444111111111
110000000000000050000000000000000011
110000000000000000000000000000000011
110000000000000000000000000000000011
110000000000000000000000000000000011
110000000000000000000000000000000011
1100000000H00000000000000M0000000011
110002222222200000000002222222200011
110002000000000000000000000000200011
110002000000000000000000000000200011
110002000000000000000000000000200011
1100020Z00000000000000000000Z0200011
110002222222222000000222222222200011
110002000000000000000000000000200011
110002000000000000000000000000200011
110002000000000000000000000000200011
110002000000000000000000000000200011
110002222222222220022222222222200011
110000000000000000000000000000000011
110000000000000000000000000000000011
110000000000000000000000000000000011
110000000000000000000000000000000011
112222200222000000000000222002222211
110000000000000000000000000000000011
110000000000000000000000000000000011
111111111333311111111113333111111111