111111111000011111111110000111111111
110000001000000000000000000100000011
110000001000000000000000000100000011
110000001110000000000000011100000011
110000000000000000000000000000000011
110000000000000000000000000000000011
110000Z0000000000000000000000Z000011
110000222222220000000022222222000011
110000200000220000000022000002000011
110000200000220000000022000002000011
110000200000220000000022000002000011
11000020Z000220000000022000Z02000011
110000222200220000000022002222000011
110000000000220000000022000000000011
110000000000220000000022000000000011
110000000000000000000000000000000011
110000222200000000000000002222000011
110000200000000000000000000002000011
110000200000000000000000000002000011
110000200000000000000000000002000011
1100002000Z00000000000000Z0002000011
110000222222200002200000222222000011
110000000000000000000000000000000011
110000000000000000000000000000000011
110000000000000000000000000000000011
111111111333311111111113333111111111