111111111444411111111114444111111111
110000000000000050000000000000000011
110000000000000000000000000000000011
110000000000000000000000000000000011
1100001000000000000000H0000001000011
110000202222222222222222222222000011
110000000000000000000000000000000011
110000000000000000000000000000000011
110000000000000000000000000000000011
1100001000000000000Z0000000001000011
110000222222222222222222222202000011
110000000000000000000000000000000011
110000000000000000000000000000000011
110000000000000000000000000000000011
1100001000000000H0000000000001000011
110000202222222222222222222222000011
110000000000000000000000000000000011
110000000000000000000000000000000011
110000000000000000000000000000000011
1100001000000Z0000000000000001000011
110000222222222220022222222222000011
110000000000000000000000000000000011
110000000000000000000000000000000011
110000000000000000000000000000000011
110000000000000000000000000000000011
111111111333311111111113333111111111