111111111444411111111114444111111111
110000000000000000000000000000000011
110000000000000000000000000000000011
110000000000000000000000000000000011
110Z0000000000000000000000000000Z011
112222220000000000000000000022222211
110000000000000000000000000000000011
110000000000000000000000000000000011
110000000000000000000000000000000011
110000Z0000000000000000000000Z000011
112222222220000000000000002222222211
110000000000000000000000000000000011
110000000000000000000000000000000011
110000000000000000000000000000000011
110000000000000000000000000000000011
112222222222220000000002222222222211
110000000000000000000000000000000011
110000000000000000000000000000000011
110000000000000000000000000000000011
110000000000000000000000000000000011
110022222222222200002222222222220011
110000000000000000000000000000000011
110000000000000000000000000000000011
110000000000000000000000000000000011
110000000000000000000000000000000011
111111111333311111111113333111111111