111111111444411111111114444111111111
110000000000000000000000000000000011
110000000000000000000000000000000011
110000100000000000000000000001000011
1100001000Z0000000000000Z00001000011
110000100022000000000000220001000011
110000100000000000000000000001000011
110000100000000000000000000001000011
110000100000000000000000000001000011
1100001000Z0000000000000Z00001000011
110000100022000000000000220001000011
110000100000000000000000000001000011
110000000000000000000000000000000011
110000000000000000000000000000000011
110000000000000000000000000000000011
110000000022222222222222220000000011
110000000000000000000000000000000011
110000000000000000000000000000000011
110000000000000000000000000000000011
110000000000000000000000000000000011
112222200022002222222200220002222211
110000000000000000000000000000000011
110000000000000000000000000000000011
110000000000000000000000000000000011
110000000000000000000000000000000011
111111111111111111111111111111111111