111111111444411111111114444111111111
110000000000000000000000000000000011
110000000000000000000000000000000011
110000000000000000000000000000000011
1100000Z00000000000000000000Z0000011
110002222000000002200000000222200011
110000000000000000000000000000000011
110000000000000000000000000000000011
11000Z000000000000000000000000Z00011
110022220000000222222000000022220011
110000000000000000000000000000000011
110000000000000000000000000000000011
11000000000000000Z000000000000000011
110002222000022222222220000222200011
110000000000000000000000000000000011
110000000000000000000000000000000011
110000000000000000000000000000000011
110000222200022220022220002222000011
110000000000000000000000000000000011
110000000000000000000000000000000011
110000000000000000000000000000000011
110000222222222000000222222222000011
110000000000000000000000000000000011
110000000000000000000000000000000011
110000000000000000000000000000000011
111111111111111111111111111111111111