111111111444411111111114444111111111
110000000000000005000000000000000011
110000000000000000000000000000000011
110000000000000000000000000000000011
110000000000000000000000000000000011
112222000000000000000000000000222211
110000000000000000000000000000000011
1101111111Z00000000000000Z1111111011
110000011110000000000000011110Z00011
112222011110000000000000011110222211
110000011110000000000000011110000011
11000001111110000O000001111110000011
110000000001100000000001100000000011
1122222220011110O00O0111100222222211
110000000001111000000111100000000011
110000000001111000000111100000000011
110000000000001110011100000000000011
112222222222001110011100222222222211
110000000000001110011100000000000011
110000000000001110011100000000000011
110000000000000010010000000000000011
112222002222222010010222222200222211
110000001000000000000000000100000011
110000001000000000000000000100000011
1100000010000000Z00Z0000000100000011
111111111333311111111113333111111111