111111111111111111111111111111111111
110000000000000000000000000000000011
110000000000000000000000000000000011
110000000000000000000000000000000011
110000000000000000000000000000000011
110000011110111101100011011110000011
110000010010100101010101010000000011
110000010000100101001001010000000011
110000010110111101000001011110000011
110000010010100101000001010000000011
110000011110100101000001011110000011
110000000000000000000000000000000011
110000011110100010111110111110000011
110000010010100010100000100010000011
110000010010100010100000111110000011
110000010010100010111110101000000011
110000010010010100100000100100000011
110000011110001000111110100010000011
110000000000000000000000000000000011
110000000000000000000000000000000011
110000000000000000000000000000000011
110000000000000000000000000000000011
110000000000000000000000000000000011
110000000000000000000000000000000011
110000000000000000000000000000000011
111111111111111111111111111111111111