111111111111111111111111111111111111
110000000000000000000000000000000011
110000000000000000000000000000000011
110000000000000000000000000000000011
110000000000000000000000000000000011
110000000000000000000000000000000011
110000000000000000000000000000000011
110000000000000222222000000000000011
110000000000000000000000000000000011
110000000000000000000000000000000011
110000000000000000000000000000000011
110000000000000000000000000000000011
110002222222222000000222222222200011
110002000000000000000000000000200011
110002000000000000000000000000200011
110002000000000000000000000000200011
110002000000000000000000000000200011
110002222222222220022222222222200011
110000000000000000000000000000000011
110000000000000000000000000000000011
110000000000000000000000000000000011
110000000000000000000000000000000011
112222200222000000000000222002222211
110000000000000000000000000000000011
110000000000000000000000000000000011
110000000000000000000000000000000011
111111111000011111111110000111111111