111111111444411111111114444111111111
110000000000000005000000000000000011
110000000000000000000000000000000011
110000000000000000000000000000000011
11000000000000000000000000000Z000011
110000222222222222222222222222222211
110000000000000000000000000000000011
110000000000000000000000000000000011
110000000000000000000000000000000011
110000000000000000000000M00000000011
112222222222222222222222222222000011
110000000000000000000000000000000011
110000000000000000000000000000000011
110000000000000000000000000000000011
1100000000000000M0000000000000Z00011
110000222222222222222222222222222211
110000000000000000000000000000000011
110000000000000000000000000000000011
110000000000000000000000000000000011
110000000000000000000000000000000011
110022222222222220022222222222220011
110000000000000000000000000000000011
110000000000000000000000000000000011
110000000000000000000000000000000011
110000000000000000000000000000000011
111111111333311111111113333111111111